3,2,30,2,4,3,2,12,4
1,3,9,9,41,10,2,4,1
5,41,6,1,5,9,4,1,1
3,10,2,8,3,42,6,5,6
5,2,12,6,31,5,2,2,2
